##########
#    #####
# $.$@####
#    #####
# ########
# ########
#. #######
#  #######
#   ######
##########
