##########
##########
##########
##########
######## #
###      #
### $  ..#
##@$  ####
###   ####
##########
