##########
##########
######## #
######## #
#####    #
######.  #
#####    #
##### $$ #
#####. @ #
##########
