##########
##########
##########
# ########
# ########
#. #######
#  #######
#$.$@#####
#   ######
##########
