##########
#######  #
###### $ #
###### $@#
#####  . #
######.  #
######   #
######  ##
######  ##
##########
