##########
#######  #
#######$ #
######   #
###@$ .  #
##  #  #.#
##  ######
##########
##########
##########
