##########
#####@  .#
#### $   #
####   ###
####  ####
####    ##
# $  .   #
#        #
# ########
##########
