##########
##########
##########
##########
## # #####
#@.    $ #
# $      #
#   ####.#
#   ######
##########
