##########
##########
##########
##########
###@######
# $$.#####
#     ####
# ##.#####
#     ####
##########
