##########
##########
##########
##########
##########
##########
#  #######
# $. ##  #
#@$    . #
##########
