##########
#######  #
####### $#
#######  #
######## #
#######@ #
#######$ #
#######. #
####### .#
##########
