##########
#   .  ###
#@$   ####
# ##  ####
#  #   ###
#   $  ###
#     ####
#####.####
##########
##########
