#######
#   # #
# .   #
#  @  #
#   $ #
##   ##
#######
