#######
#. #  #
#$ # ##
#     #
#@   ##
#######
#######
