#######
#    @#
#   . #
#$    #
#.  $ #
# #  ##
#######
