#######
# @  ##
#  #  #
## ## #
# $ # #
##.   #
#######
