#######
## #  #
# . $ #
#  # @#
#### ##
###  ##
#######
