#######
##  ###
#    @#
## #$ #
#   . #
#  #  #
#######
