#######
##   ##
####  #
#   $@#
# ##.##
###   #
#######
