#######
#     #
#  $..#
# $   #
##  # #
## @# #
#######
