#######
#  ## #
#@    #
##    #
# $# ##
#  .  #
#######
