#######
# ##  #
# $ .##
#  @###
##    #
#  ####
#######
