#######
## #  #
# $   #
#     #
##   .#
#    @#
#######
