#######
##.   #
# $   #
#     #
#  #  #
#@#   #
#######
