#######
#    ##
##$   #
#.@  ##
###   #
#     #
#######
