#######
###   #
# $@ .#
#   # #
#     #
#   # #
#######
