#######
# #  ##
# $@  #
#  $  #
# . # #
#    .#
#######
