#######
#    ##
#  $  #
# .   #
## # ##
#  @ ##
#######
