#######
##.  ##
# @   #
## $  #
##.$  #
###   #
#######
