#######
# @ ###
# .  ##
# $   #
##    #
#    ##
#######
