#######
#.    #
# $@ ##
## # ##
##   ##
####  #
#######
