#######
# ##  #
#   $ #
##    #
#   @ #
#  #. #
#######
