#######
##   ##
#   $ #
# .  @#
#     #
## ## #
#######
