#######
#  # .#
#     #
##    #
# #$  #
#  @  #
#######
