#######
# ##  #
# #@ ##
# $   #
#  . ##
##    #
#######
