#######
#.    #
#     #
#$ $  #
#.    #
#### @#
#######
