#######
#   # #
## @  #
#    .#
#   $ #
##    #
#######
