#######
# .#  #
#     #
#   $ #
#   @ #
# #   #
#######
