#######
##   ##
# $   #
#    @#
##   ##
#    .#
#######
