#######
#  @ ##
# $   #
#     #
# $ . #
#.    #
#######
