#######
#  ####
# $.# #
#  .$@#
#   # #
##    #
#######
