#######
###  @#
#   ###
#  $ ##
#  #  #
#.    #
#######
