#######
#  @  #
#  $  #
# $   #
##  ..#
##   ##
#######
