#######
####  #
#.  @ #
#   $ #
#     #
#   # #
#######
