#######
#.   @#
#  $ ##
# $  ##
#   .##
#     #
#######
