1111111
1100101
1023001
1000011
1400001
1000001
1111111

urddrdll