1111111
1040001
1000041
1000011
1230301
1100001
1111111

rdrruudldluuurr