1111111
1001001
1003401
1201001
1101011
1000011
1111111

rur