#######
##@#  #
# $   #
#     #
#     #
# #.  #
#######
