#######
##  . #
# #   #
#@ #$ #
#     #
# # # #
#######
