#######
##   ##
#   @ #
# #   #
##  # #
#  $ .#
#######
