111111111
111111111
111110011
111003011
111042011
110010011
110110111
111111111
111111111

ruuldrdl