111111111
111111111
111000011
110000111
114000111
110103011
110000211
111111111
111111111

uldlurull