111111111
111111111
110001011
112101011
114030011
110100011
110100011
111111111
111111111

drrdrrulll