111111111
111111111
110041111
110300011
110000011
111200111
111010111
111111111
111111111

uulur