111111111
111111111
110100111
110001011
110300011
111000011
111421111
111111111
111111111

uuuldd