111111111
111111111
110000011
111013011
110000011
111002111
110410011
111111111
111111111

uruuldrdllruullddd