111111111
111111111
110000011
110012011
111030411
111100111
110000011
111111111
111111111

ullddrr