111111111
111111111
111001011
114001011
110320011
110000111
111011111
111111111
111111111

ldlu