111111111
111111111
110002111
110000111
110000011
114301011
111001111
111111111
111111111

ldddl