111111111
111111111
110020011
111401011
111311011
110000011
111001111
111111111
111111111

rrdddlllu