111111111
111111111
110101411
110000011
111003011
111000111
110211111
111111111
111111111

urrulurdru