111111111
111111111
112400011
111000011
110030011
111100011
111001111
111111111
111111111

rrrdddluurul