111111111
111111111
110000011
111013011
110000211
110000411
110100111
111111111
111111111

uulddldr