111111111
111111111
110110411
110000011
111020011
110130111
110000111
111111111
111111111

rddluulurrdru