111111111
111111111
110000011
110400011
110012011
110301011
110000011
111111111
111111111

rddllluu