111111111
111111111
112000111
110300011
110101111
114000011
110011011
111111111
111111111

rrdluldd