111111111
111111111
111001011
110000011
111010311
111000411
110012011
111111111
111111111

uuurd