1111111111
1400001001
1010110001
1030000101
1001000101
1011100101
1000100011
1020000001
1001010001
1111111111

rrruuululldluu