1111111
1430201
1000001
1030001
1000011
1100411
1111111

lldldrrurdd