1111111
1000041
1030001
1032001
1000001
1140001
1111111

uulldrddruulurr