1111111
1000001
1003341
1020401
1000001
1011011
1111111

uurdldrur