1111111
1001101
1204001
1000001
1001311
1000011
1111111

rdddrruurul