1111111
1110021
1000111
1003011
1001001
1400001
1111111

lldldddrruulluldd