#######
#   ###
# @   #
#$$   #
#.    #
# # . #
#######
