#######
## @  #
#  $. #
#     #
#  $  #
#.#   #
#######
