#######
###   #
##@  $#
#     #
#    .#
### # #
#######
