##########
#   ##   #
##.      #
#    #  ##
# #   #  #
#@ $#  $ #
#   #  # #
# # #    #
# #   .# #
##########
