##########
## ## #  #
#       ##
#      .##
#  #  #  #
## #  #@ #
#        #
#   $    #
# #  ##  #
##########
