##########
# # ###  #
#@#   #  #
# #      #
#.   #  ##
## #$# ###
## #   # #
#        #
# ####   #
##########
