##########
###      #
#        #
#  $   $##
# # #.  ##
#      @ #
#       ##
#    ##  #
##   ##. #
##########
