##########
#   ##   #
# $  #   #
#      # #
## #$#   #
#    #   #
#        #
## #.#@ .#
#      # #
##########
