##########
#@   #   #
### ##   #
##.    # #
##  #  # #
#  .$  # #
##  #$## #
###      #
#   ##   #
##########
