##########
###     ##
#   ### ##
## $     #
#      @ #
## ## ## #
##    # .#
##       #
#    # # #
##########
