##########
#        #
#    $  @#
# ## ##  #
#        #
###$    .#
#        #
#      # #
##     .##
##########
