1111111
1400001
1010001
1023001
1000001
1000101
1111111

druurull