1111111
1100011
1000001
1100001
1000101
1034201
1111111

lulldr