#######
#@   ##
#. $  #
#    $#
#. $  #
#    .#
#######
