#######
#######
#   $.#
#     #
## @  #
#     #
#######
