#######
#    ##
## $  #
#    ##
#     #
# @  .#
#######
