#######
##  # #
##    #
#   $.#
###   #
### @ #
#######
