111111111111
100000000011
100000040001
100030000011
100000011001
101100020001
100131110001
100001040001
100014000311
101000000011
100011010001
111111111111
