#######
#.   ##
#    ##
#     #
#   $ #
#.$  @#
#######
