#######
## #  #
#  .  #
# $.  #
# $   #
##@   #
#######
