#######
#@    #
#     #
#  $ .#
#   .$#
#     #
#######
