111111111111
100000400001
100000000001
100010001001
104000000101
110010003001
120010003001
100010000001
100000000001
100013000001
100000104001
111111111111
