111111111111
100000000001
100000000001
100000000001
100004000111
104413000001
100000000001
100000031001
100030000001
100010002001
100000000001
111111111111
