111111111111
100001000101
100004003101
100034100001
100000000001
100000330001
100004000001
100000000001
100000000001
100000000101
100010400201
111111111111
