111111111111
100000000001
100000010001
100130000001
100000001001
100004001001
140030011001
100000040001
100010000011
102030000001
100000010001
111111111111
