1111111
1400001
1300001
1000201
1000001
1000001
1111111

lllu