1111111
1000011
1332041
1000001
1400001
1000001
1111111

ullddurrr