1111111
1104001
1030101
1420001
1030011
1000011
1111111

lurdruddldlu