1111111
1000201
1010001
1034011
1010001
1100011
1111111

lllddr