#######
## ####
#.    #
#$@# ##
#     #
# $.  #
#######
