#######
# #   #
#  # ##
# @.  #
#.$$  #
#    ##
#######
