111111111
111111111
111140011
110030011
111100011
110010111
111020011
111111111
111111111

ruulu