111111111
111111111
111100011
110100111
110400011
110123011
111100011
111111111
111111111

drurull