111111111
111111111
110000011
112031111
110000111
110040111
110110011
111111111
111111111

rurdd