111111111
111111111
112011011
111011011
110300011
110041011
111001011
111111111
111111111

rddldr