111111111
111111111
110021011
111010011
111030411
110001011
111001011
111111111
111111111

lddrr