111111111
111111111
110011111
111410111
111030011
110002011
110011011
111111111
111111111

uldlu