111111111
111111111
110000011
114030011
111011111
111000011
111020011
111111111
111111111

luuuurrdll