111111111
111111111
110110011
110004011
110020111
110130111
110001111
111111111
111111111

llddrruulur