111111111
111111111
111111011
110000011
111020011
110011111
110030411
111111111
111111111

lddrr