111111111
111111111
110111011
112100411
110031011
111000011
111110011
111111111
111111111

drdrrruulldldrrdruu