111111111
111111111
110000011
110001011
111230011
111004011
111001011
111111111
111111111

urdldr