111111111
111111111
111112011
110040111
110000111
110300111
110000011
111111111
111111111

dlllddrdruu