111111111
111111111
111000011
111030011
114000011
111001111
111120111
111111111
111111111

uluuurdrdll