111111111
111111111
110101011
112140011
110003011
111110011
110000011
111111111
111111111

drrurrddlurul