1111111
1001111
1003011
1400011
1021011
1000011
1111111

urrulluld