1111111
1100011
1111001
1000201
1003001
1410101
1111111

dlluld