1111111
1110011
1010001
1030101
1002001
1100401
1111111

llurdrrruullddldr