1111111
1000001
1100041
1023001
1003111
1400001
1111111

urrdluldlddrrulrulldruurr