1111111
1001001
1104011
1000011
1000301
1200001
1111111

rrrruldluu