1111111
1000411
1010201
1000301
1010101
1100001
1111111

rdlrddlluuudlluurr