1111111
1040011
1100111
1002101
1030101
1000001
1111111

ddluuu