1111111
1110201
1000111
1000001
1134101
1100101
1111111

lddddluruulldrurd