1111111
1010011
1003211
1004011
1100001
1000001
1111111

uld