1111111
1000011
1410011
1032111
1000111
1100001
1111111

ldlu