1111111
1024001
1100001
1103001
1100001
1100001
1111111

dddruu