1111111
1000111
1000101
1100101
1432101
1000001
1111111

l