1111111
1010001
1002111
1003011
1004001
1000011
1111111

d