1111111
1030401
1001021
1103001
1000401
1001011
1111111

lddllurdrruuldllulurr