1111111
1100101
1030041
1011011
1020011
1110011
1111111

luurrr