1111111
1400211
1000001
1031001
1100011
1000001
1111111

dddlluurul