1111111
1104001
1000011
1002301
1110001
1111111
1111111

drruldluu