1111111
1100021
1003001
1100111
1100001
1104101
1111111

llddd