1111111
1000001
1014101
1102301
1000011
1110001
1111111

uurrddldlu