1111111
1002101
1400001
1003001
1000011
1001001
1111111

drdlldlu