1111111
1240001
1000001
1010101
1110301
1100001
1111111

rrrrdddldluuurul