1111111
1021001
1100011
1411011
1030001
1000111
1111111

drrddlldlu