1111111
1101401
1000001
1000001
1113111
1200001
1111111

rruulurdru