1111111
1104111
1002001
1100301
1100001
1100001
1111111

rrdldluu