1111111
1102111
1030101
1100101
1400101
1100001
1111111

lddrdl