1111111
1001101
1000001
1201001
1000031
1100141
1111111

rurrrdd