1111111
1100111
1041101
1000301
1000001
1201111
1111111

rurrrulldlu