1111111
1001001
1011001
1002011
1043001
1010011
1111111

rdl