1111111
1111041
1001031
1004101
1032001
1000101
1111111

ulldrdrurruu