1111111
1000011
1000011
1231001
1000401
1100101
1111111

urdldrr