1111111
1010011
1000301
1100101
1100201
1000401
1111111

ruululdddldr