1111111
1000011
1103211
1000001
1400011
1100001
1111111

lulddrdl