1111111
1102011
1110001
1033001
1400001
1114111
1111111

dddllurrurdrdlll