1111111
1100001
1100011
1004001
1032111
1100111
1111111

dlulur