1111111
1200001
1000011
1001001
1030401
1101001
1111111

dddrr