1111111
1110011
1043001
1100011
1020001
1100011
1111111

rruul