1111111
1000011
1110021
1110341
1001011
1100001
1111111

lldr