1111111
1140011
1001001
1100001
1201301
1100001
1111111

rdrrurullrddlluuu