1111111
1001011
1101011
1004021
1030001
1010011
1111111

lllldrrdrurul