1111111
1100421
1000011
1100001
1000301
1000101
1111111

lddrdlullddruuulur