1111111
1010011
1004011
1000011
1113111
1102001
1111111

uu