1111111
1000041
1000001
1003031
1004001
1001121
1111111

uuulld