1111111
1003041
1000101
1000101
1002001
1110101
1111111

luuurr