1111111
1400001
1000001
1303001
1400001
1111021
1111111

luluurulldld