1111111
1001001
1000101
1103001
1142301
1110141
1111111

rululdrrrd