1111111
1010001
1000301
1130041
1000001
1400021
1111111

lluuururdlllddrdl