1111111
1111001
1000001
1002041
1103011
1100001
1111111

ldrdrulur