1111111
1001041
1000001
1100001
1013001
1002001
1111111

uulurrdru