1111111
1011001
1012011
1030001
1004011
1100001
1111111

ddllurdrruuld