1111111
1000101
1000101
1020001
1103411
1100111
1111111

dr