##########
#    #####
#@$  #####
#    #####
###  #####
###  ##  #
###      #
####    .#
##########
##########
