##########
# .#######
#    $@###
#      ###
##########
##########
##########
##########
##########
##########
