##########
#######  #
######## #
#######  #
##### .$@#
#####    #
######## #
##########
##########
##########
