##########
# # #   ##
#@$    ###
# #    ###
######  ##
###### ###
#####   ##
#####  ###
###   . ##
##########
