##########
######   #
####### ##
####### ##
#######.##
#### #  ##
#### ##  #
###@$   ##
###      #
##########
