##########
#. #######
#  #######
#  $@#####
#  #######
#  #######
#  #######
#  #######
#  #######
##########
