##########
#####   ##
#####   ##
#####   ##
## @    ##
## $ # ###
##     ###
##     ###
##    . ##
##########
