##########
##########
##########
##########
##########
# #### ###
#      ###
#. $@# ###
#  #######
##########
