##########
##########
##########
##########
##### ####
##.      #
##  #    #
##### $###
#     @###
##########
