#######
##  # #
#   . #
#  # ##
## $ ##
#   @##
#######
