##########
#####    #
#####@$  #
###### .##
######  ##
####### ##
##########
##########
##########
##########
