##########
##########
##########
##########
##########
##########
#   # ## #
#      $@#
#    .   #
##########
