##########
####   ###
# ##   ###
#  .   ###
#      ###
#     ####
##    ####
##  #$ ###
##  #@####
##########
