##########
#   .    #
##       #
######   #
#####   ##
#####  $##
###### @##
###    ###
###    ###
##########
