##########
#        #
#  .   $@#
#  ##### #
# ###### #
# ########
# ########
##########
##########
##########
