##########
#       ##
#@$      #
## ###   #
#### .   #
##### ####
##########
##########
##########
##########
