##########
##########
##########
##########
##########
##########
#####.####
###@$  ###
#      ###
##########
