##########
##########
##########
##########
##########
##########
#      ###
#@$    ###
#     .###
##########
