##########
#     .  #
#        #
# $  ### #
# @ ######
##########
##########
##########
##########
##########
