##########
##########
##########
##########
##########
######@ ##
##### $###
#####.  ##
###      #
##########
