##########
#        #
##@$     #
######## #
######## #
#######  #
####### .#
#######  #
#######  #
##########
