111111111
111111111
110001011
111000011
110023011
111110111
111004011
111111111
111111111

urdd