111111111
111111111
110011111
110110111
110403011
111000011
111423011
111111111
111111111

urrullrrddll