111111111
111111111
111100111
110000011
111011011
110120011
114300111
111111111
111111111

dl