111111111
111111111
111041011
111000011
111030011
110021111
110100111
111111111
111111111

uu