111111111
111111111
110211011
111004011
111100111
110300111
110000111
111111111
111111111

drdddllurrdruu