111111111
111111111
111100011
111100111
110002411
110030111
110100011
111111111
111111111

ddlulurr