111111111
111111111
110000011
110302111
110100011
110000011
110000411
111111111
111111111

lulldrrurdddldr