111111111
111111111
110000111
111100111
110042011
110300011
110000011
111111111
111111111

llldrdru