111111111
111111111
111040011
110000011
111103011
110020011
110100011
111111111
111111111

ruurul