111111111
111111111
110001011
110004011
111311011
110000011
111102111
111111111
111111111

luludrrruullulldrr