111111111
111111111
114000011
110011011
111300011
111002011
111000011
111111111
111111111

lluudrrruulll