1111111
1010201
1000311
1400001
1300401
1000011
1111111

ddllddlu