1111111
1100011
1032001
1000001
1004001
1100001
1111111

ulddldr