1111111
1124001
1000301
1100001
1101001
1100011
1111111

rrrdldlu