1111111
1101141
1100301
1000001
1000321
1040001
1111111

lluldruurdru