1111111
1100401
1000401
1030021
1003001
1100001
1111111

lddluuuddlulurrlur