1111111
1000401
1010301
1002001
1100111
1001111
1111111

ru