1111111
1400011
1311111
1200001
1011011
1011001
1111111

u