1111111
1000001
1230411
1110101
1000001
1001101
1111111

rr