1111111
1114301
1101121
1100001
1100101
1100001
1111111

ul