1111111
1100011
1000011
1020001
1030011
1141001
1111111

d