1111111
1100101
1000001
1101011
1021001
1003411
1111111

dr