1111111
1011001
1430001
1002001
1000001
1111101
1111111

ul