1111111
1100111
1000041
1110031
1110121
1100111
1111111

u