1111111
1210001
1034101
1100001
1110001
1100001
1111111

dr