1111111
1000101
1101001
1143021
1000001
1000011
1111111

ll