1111111
1000111
1100111
1110201
1043001
1010001
1111111

dl