1111111
1001111
1100111
1000011
1100011
1403201
1111111

ll