1111111
1110001
1010111
1000001
1011111
1430201
1111111

ll