1111111
1000101
1002001
1430101
1000101
1011111
1111111

dl