1111111
1100111
1010001
1000011
1000001
1040321
1111111

ll