1111111
1040011
1131001
1020111
1011011
1000001
1111111

u