1111111
1100001
1102011
1000011
1003011
1114111
1111111

dd