1111111
1020341
1000011
1010001
1000101
1011111
1111111

rr