1111111
1111001
1000001
1020001
1003401
1011001
1111111

dr