1111111
1010001
1010101
1043021
1011011
1111001
1111111

ll