1111111
1003401
1020011
1000101
1110001
1100001
1111111

ur