1111111
1200111
1031111
1040001
1101101
1001111
1111111

rd