1111111
1020001
1000011
1130001
1040011
1000011
1111111

dd