1111111
1000021
1010311
1001401
1000011
1001011
1111111

ld