1111111
1000111
1002011
1100111
1003011
1004001
1111111

dd