1111111
1001111
1104001
1003001
1100001
1112101
1111111

uu