1111111
1110211
1100001
1001311
1001411
1010001
1111111

dd