1111111
1234101
1000001
1011011
1100011
1001001
1111111

r