1111111
1100401
1000301
1110201
1000001
1110011
1111111

u