1111111
1000011
1110201
1010311
1000001
1000401
1111111

dd