1111111
1201111
1310001
1010001
1400001
1110011
1111111

dd