1111111
1000001
1110101
1403201
1000101
1001001
1111111

ll