1111111
1000011
1000111
1123041
1110111
1000111
1111111

rr