1111111
1000001
1101111
1100011
1230411
1011111
1111111

rr