1111111
1010111
1000001
1432011
1010011
1000111
1111111

l