1111111
1101001
1000001
1011001
1203401
1011101
1111111

rr