1111111
1141001
1100101
1030001
1020011
1110001
1111111

uu