1111111
1100001
1020111
1130111
1100111
1141111
1111111

dd