1111111
1004001
1013001
1002011
1101001
1000001
1111111

u