1111111
1011101
1000201
1113011
1104001
1001011
1111111

ld