1111111
1100001
1121001
1030001
1140101
1000111
1111111

d