1111111
1000001
1000011
1020001
1113001
1104011
1111111

rd