1111111
1100001
1143011
1000201
1000101
1010101
1111111

ul