1111111
1000011
1102011
1103001
1004011
1010001
1111111

d