1111111
1111011
1021001
1103411
1000001
1100001
1111111

dr