1111111
1001201
1100001
1001301
1111401
1100001
1111111

dd