1111111
1000001
1110001
1000111
1043021
1010101
1111111

ll