1111111
1101101
1100101
1004321
1000001
1000001
1111111

l