1111111
1100111
1000041
1101031
1001021
1001011
1111111

u