1111111
1100111
1100011
1002001
1103001
1104011
1111111

d