1111111
1010411
1000301
1110011
1000201
1111111
1111111

uu