1111111
1010111
1000001
1102101
1430011
1000011
1111111

dl