1111111
1102001
1430011
1101011
1101011
1101001
1111111

dl