1111111
1000011
1010011
1110101
1230401
1000101
1111111

rr