1111111
1002001
1000341
1000001
1110101
1100011
1111111

dr