1111111
1004001
1000001
1103001
1002011
1000001
1111111

uu