1111111
1011001
1011011
1000011
1102341
1000101
1111111

r