1111111
1121011
1103401
1100001
1000001
1000111
1111111

dr