1111111
1010011
1000001
1101001
1432001
1111001
1111111

l