1111111
1100111
1010401
1000011
1001311
1100201
1111111

uu