1111111
1110101
1004301
1101021
1101001
1001101
1111111

ul