1111111
1000111
1000011
1010211
1113011
1104011
1111111

ld