1111111
1012001
1430011
1011001
1000001
1110011
1111111

dl