1111111
1100001
1400011
1011011
1310001
1211011
1111111

uu