1111111
1000001
1120111
1031011
1000001
1140111
1111111

dd