1111111
1001001
1001401
1001311
1002011
1111111
1111111

ru