1111111
1010111
1010001
1001101
1430201
1000001
1111111

ll