1111111
1000111
1004301
1001121
1010001
1111011
1111111

ul