1111111
1004001
1113101
1100201
1101101
1100111
1111111

lu