1111111
1011001
1000011
1200111
1030101
1140001
1111111

rd