1111111
1110021
1000131
1001041
1010011
1000011
1111111

d