1111111
1110001
1011001
1010001
1430201
1111011
1111111

ll