1111111
1001101
1100001
1140321
1000101
1000001
1111111

ll