1111111
1001011
1200011
1030001
1040101
1000011
1111111

rd