1111111
1000201
1130001
1004111
1000001
1101011
1111111

lldrddllur