1111111
1000111
1010001
1000341
1100001
1102111
1111111

uur