1111111
1000111
1301111
1001021
1400001
1000001
1111111

ldlluuuldd