1111111
1001011
1000001
1410111
1300001
1001201
1111111

ulldlu