1111111
1001001
1000001
1123101
1004001
1001011
1111111

urd