1111111
1000001
1000001
1100021
1003001
1041101
1111111

ldluld