1111111
1001101
1000001
1100031
1101041
1403201
1111111

llrruuurd