1111111
1010021
1030001
1000001
1000011
1400001
1111111

llddllurrurdrdllluldd