1111111
1000001
1032101
1000141
1000001
1101001
1111111

ulddldrrrdru