1111111
1000001
1011111
1240011
1003001
1100001
1111111

rrrdldlu