1111111
1000001
1002011
1410111
1003001
1100101
1111111

llddrdruudlluururrdlluld