1111111
1200011
1013011
1400011
1001001
1111001
1111111

rrdrdll