1111111
1000111
1114001
1002301
1010001
1010001
1111111

drurul