1111111
1001101
1003401
1100011
1001011
1021001
1111111

uuur