1111111
1100011
1103111
1020111
1100041
1000111
1111111

uurddldrr