1111111
1110001
1100311
1040001
1110121
1100001
1111111

ulluurdldddrruull