1111111
1400001
1000101
1101011
1130001
1020001
1111111

uuurul