1111111
1010011
1020441
1000311
1003011
1100001
1111111

dddruulurrlddru