1111111
1001101
1040001
1123001
1111001
1000011
1111111

rurrddlurull