1111111
1401101
1000201
1000101
1003001
1000101
1111111

rddllldluuu