1111111
1101111
1204111
1010001
1013111
1000001
1111111

dddrruu