1111111
1000011
1231001
1004111
1000001
1001011
1111111

urdldr