1111111
1000001
1102311
1000041
1010101
1011001
1111111

urdldr