1111111
1000111
1100301
1042001
1100101
1100101
1111111

rrulluld