1111111
1000001
1200011
1003011
1011411
1011001
1111111

rdrurd