1111111
1120001
1010101
1000011
1000001
1103401
1111111

rddlddr