1111111
1430011
1000011
1000211
1001011
1110011
1111111

luul