1111111
1100011
1003001
1011431
1000041
1102101
1111111

luluurrurdrd