1111111
1000001
1131001
1400011
1011001
1111211
1111111

uuuulldurrddll