1111111
1110111
1000001
1011311
1400021
1000001
1111111

lllluurrrdulllddrrdrrulll