#######
#     #
# ## ##
#  $.##
#   @##
##    #
#######
