#######
##    #
## #  #
##  @##
#  $  #
## #. #
#######
