#######
### . #
####$ #
#    ##
#   @ #
#  ## #
#######
