#######
##  ###
# #@ ##
#   $ #
# .   #
#  ## #
#######
