1111111
1000101
1020101
1400101
1003001
1000001
1111111

dddrrulldlu