1111111
1010001
1000001
1030001
1020301
1000441
1111111

lurrrduurdd