1111111
1111111
1110001
1110101
1030401
1000021
1111111

llllurr