111111111
111111111
110010111
111000011
114302111
111010111
111010111
111111111
111111111

ll