111111111
111111111
111000111
111110011
110023411
110101011
111111011
111111111
111111111

r