111111111
111111111
110000011
110430011
110102011
110000011
111011111
111111111
111111111

ul