111111111
111111111
110001111
111021111
110030011
110041011
111000111
111111111
111111111

d