111111111
111111111
110100111
110010011
110100111
110043211
111111011
111111111
111111111

l