111111111
111111111
111111111
110014111
110003011
110102011
111000011
111111111
111111111

u