111111111
111111111
110001111
110140011
111131111
111120111
111000111
111111111
111111111

u