111111111
111111111
111000111
111101111
111101111
111230411
110010011
111111111
111111111

rr