111111111
111111111
111102111
110013111
110000011
111004011
111010111
111111111
111111111

dd