111111111
111111111
110000411
110100311
111102011
111011011
111000011
111111111
111111111

ru