111111111
111111111
111111111
111110111
110004011
110003111
111010211
111111111
111111111

lu