111111111
111111111
111410011
110000011
110310111
111201111
110000011
111111111
111111111

uu