111111111
111111111
111110011
110100111
110000411
110000311
110000211
111111111
111111111

u