111111111
111111111
110000111
110200111
111300111
110010111
111410011
111111111
111111111

dd