111111111
111111111
110011111
110002011
110030111
111040111
111111111
111111111
111111111

ld