111111111
111111111
110111111
110012011
110430011
110000011
110000011
111111111
111111111

dl