111111111
111111111
111001111
110000011
110010111
114032011
110110111
111111111
111111111

ll