111111111
111111111
111000111
111011411
111000311
111010211
110011111
111111111
111111111

u