111111111
111111111
110000011
111000111
111000011
110043011
110000211
111111111
111111111

ul