111111111
111111111
111010111
110010011
110210111
110034111
110101111
111111111
111111111

dr