111111111
111111111
110211111
113000011
114000111
110010011
110010111
111111111
111111111

ld