111111111
111111111
111111011
110101011
110001011
110021011
110003411
111111111
111111111

dr