111111111
111111111
111010111
111014111
111003111
111002011
111010011
111111111
111111111

u