111111111
111111111
111011111
111210011
110310111
110000111
110401111
111111111
111111111

dd