111111111
111111111
110000111
110100011
110110011
110403211
111001111
111111111
111111111

ll