111111111
111111111
110100011
110010011
110430211
110000011
110010011
111111111
111111111

ll