111111111
111111111
111000011
112304011
110001011
111001111
111000011
111111111
111111111

rr