111111111
111111111
110000111
110001011
111000011
114302111
111100011
111111111
111111111

ll