111111111
111111111
111100011
110001011
110203411
110000011
110000111
111111111
111111111

rr