111111111
111111111
111040111
110030011
110120011
110001011
111100011
111111111
111111111

u