111111111
111111111
110101011
110000411
111000311
111100011
111100211
111111111
111111111

uu