111111111
111111111
111100111
110000011
110000011
111100011
112304111
111111111
111111111

rr