111111111
111111111
111100011
110043211
111001111
110000011
111001011
111111111
111111111

l