111111111
111111111
111010411
110000311
111000211
111001011
111010011
111111111
111111111

u