111111111
111111111
111000111
110001011
111034011
111201011
110010011
111111111
111111111

ur