111111111
111111111
110000111
110111011
110040011
111031011
111021011
111111111
111111111

u