111111111
111111111
111010111
110000011
110000011
111021011
110003411
111111111
111111111

dr