111111111
111111111
110000111
110140011
110030011
111002011
111101011
111111111
111111111

lu