111111111
111111111
111000011
110010111
110012111
111013011
111114111
111111111
111111111

d