111111111
111111111
111000111
111110011
110200011
110300011
110401111
111111111
111111111

d