111111111
111111111
111000011
111100011
110203411
111110011
111100111
111111111
111111111

rr