111111111
111111111
110011011
110000011
110043211
110010111
111001111
111111111
111111111

l