111111111
111111111
111000011
111210011
110311011
111010011
110410111
111111111
111111111

dd