111111111
111111111
111100011
110230411
110100011
110010011
111000111
111111111
111111111

rr