1111111
1000011
1012011
1000011
1000301
1010411
1111111

rdd