1111111
1200011
1403001
1000031
1403001
1000041
1111111

rrrdllrrrddlll