1111111
1000011
1004041
1100001
1003131
1010021
1111111

uuddlluu