1111111
1111111
1000341
1000001
1102001
1000001
1111111

uur