1111111111
1010001011
1010000021
1000011001
1000004001
1000003101
1110010101
1000110101
1000110001
1111111111

ddddddlluuu