##########
##########
##########
##########
##########
# ###### #
#     .  #
#@$   #$ #
#    ##. #
##########
