##########
#####@  ##
#####$ ###
#  #   ###
# .    ###
#   $. ###
####  ####
##########
##########
##########
