##########
######   #
###### $ #
######   #
###### . #
#######  #
####### .#
#######$ #
#######@ #
##########
