##########
##########
##########
##########
##########
#######@ #
#######$ #
##.      #
##. $    #
##########
