111111111
111111111
110000411
110030111
110110111
110000011
111010211
111111111
111111111

lullluurrllddrrruulur