111111111
111111111
110000111
110310011
110014011
110200111
111100111
111111111
111111111

luuurddldrrdru