111111111
111111111
111000011
111001011
112301011
110040011
110110011
111111111
111111111

rurd