111111111
111111111
111001011
111400011
112013011
110110011
110111111
111111111
111111111

rurrrddlurull