111111111
111111111
112010011
110400011
111130011
110000111
110011111
111111111
111111111

rdrrddlurul