111111111
111111111
111040011
112000111
110130111
110000011
110101011
111111111
111111111

ddrruu