111111111
111111111
114000011
111032011
110110011
110000011
111011111
111111111
111111111

ulldrurrddlurulll