111111111
111111111
111001111
110100011
110003011
111210011
111400011
111111111
111111111

ururddrdll