111111111
111111111
110000211
110001111
111100111
110000011
111034111
111111111
111111111

lldddldr