111111111
111111111
110000011
111001111
111100011
114030011
112010111
111111111
111111111

rururrdlll