111111111
111111111
110001111
111101111
111032411
110000011
110111011
111111111
111111111

dllurr