111111111
111111111
110101111
110100011
110031211
111000411
111010111
111111111
111111111

ulldldrr