111111111
111111111
110000011
111120111
110030411
110000011
111010011
111111111
111111111

rddllurr