111111111
111111111
111100011
110002011
110301011
110010111
110004011
111111111
111111111

llddldrr