111111111
111111111
110101111
110000111
110030011
110211111
114000111
111111111
111111111

uurrdlluldd