111111111
111111111
112010011
110010011
111030011
110010011
111004011
111111111
111111111

rddrlddrrruuuldd