111111111
111111111
110110011
110014011
110000011
110030111
112100111
111111111
111111111

urrdruu