111111111
111111111
114010011
110002011
110030011
111001011
111001011
111111111
111111111

dldluruldlu