111111111
111111111
111000011
110000411
111020011
110030111
110000011
111111111
111111111

ldrdruulur