111111111
111111111
111000011
111121111
110030011
114000011
110011011
111111111
111111111

drdll