111111111
111111111
110000111
110300011
111204111
111000011
111011011
111111111
111111111

ruulldrrurd