1111111
1200001
1030011
1000001
1000401
1110001
1111111

rddldrr