1111111
1000201
1140001
1001001
1131011
1100011
1111111

ddddlluu