1111111
1000001
1110341
1000001
1114311
1000201
1111111

uluuurrddlruulldrld