1111111
1100011
1003011
1112401
1000001
1011011
1111111

ruulldrurd