1111111
1140001
1100101
1000101
1130001
1100211
1111111

lluuu