1111111
1040001
1000011
1000101
1123101
1000001
1111111

druuurul