1111111
1021011
1003001
1000411
1000001
1100011
1111111

ddrruldlluurdldrr