1111111
1110001
1100001
1100101
1143021
1100001
1111111

ll