1111111
1011111
1001111
1042101
1130001
1100111
1111111

ddlu