1111111
1000011
1104101
1100001
1000301
1210011
1111111

urrurrdldluu