1111111
1104201
1100301
1000011
1101011
1001011
1111111

rdldlu