1111111
1000011
1110311
1000021
1014001
1100101
1111111

lluurddrdl