1111111
1111111
1000101
1100401
1112301
1000001
1111111

dru