1111111
1001111
1411001
1000011
1031211
1000011
1111111

dlludrruulldlu