1111111
1043011
1100011
1101001
1100011
1200001
1111111

rrruuuul