1111111
1400001
1030201
1110001
1100001
1100101
1111111

lulldrrdrurulll