1111111
1100011
1030201
1001101
1100001
1041111
1111111

lulddd