1111111
1111001
1000041
1100301
1100001
1000211
1111111

uulur