1111111
1201101
1010001
1000001
1011011
1030411
1111111

ddddrr