1111111
1110111
1110111
1000101
1012001
1010341
1111111

dr