1111111
1101101
1100001
1003001
1001021
1110401
1111111

luulldrurdd