1111111
1011001
1021001
1103001
1100411
1101001
1111111

drdruruuldd