1111111
1001001
1200011
1030001
1000411
1000011
1111111

rdldrr