1111111
1100001
1000201
1400111
1030001
1000111
1111111

lddldlu