1111111
1100001
1031101
1000001
1140011
1121001
1111111

urruruullldd