1111111
1110011
1000101
1003021
1010011
1411001
1111111

llluldd