1111111
1104001
1101001
1003001
1020001
1101011
1111111

urdruurul