1111111
1100001
1031001
1400101
1200101
1000001
1111111

rrdrruuululldlddrrul