1111111
1000001
1400011
1000101
1213001
1000011
1111111

drruuluurrdll