1111111
1200001
1000001
1010341
1000011
1100001
1111111

rrddr