#######
#  #  #
# $  ##
# .   #
#     #
##@  ##
#######
