1111111
1100401
1003001
1031001
1000011
1024001
1111111

luuurrlddldrurruu