1111111
1114101
1000041
1003001
1001321
1010001
1111111

dluulullddrulurdrur