1111111
1100041
1020131
1400001
1133011
1104001
1111111

rdrrudlddlludrruullrd