1111111
1014101
1010001
1030021
1013011
1040001
1111111

lddllluurrdruruldddluuu