1111111
1400041
1003001
1201011
1030011
1001011
1111111

ddruuulurrrdlldlu