1111111
1102001
1000311
1040011
1010001
1110001
1111111

rddlddrruldlurul