1111111
1030241
1030101
1400001
1001001
1100101
1111111

lddlluurrrlldrdl