1111111
1100101
1443001
1002301
1100001
1100001
1111111

drrullrullrddlu