1111111
1000001
1033001
1020441
1101111
1100011
1111111

luurdldrrlurrurd