1111111
1000041
1101011
1030001
1000001
1011201
1111111

ulllurrdruudlluurr