1111111
1111201
1000301
1001001
1103041
1040001
1111111

dddrdllruuullddrr