1111111
1400041
1003311
1000401
1230101
1110001
1111111

rurrulrdrddlluulurulrrd