1111111
1000011
1013011
1340011
1410021
1000011
1111111

luuuldrdluulldd