1111111
1400041
1211301
1000001
1031111
1000111
1111111

drrrudlllddruluuurrrddlldluu