1111111
1100001
1431001
1003001
1010421
1000001
1111111

lullrruulldldrrddlluuruurrdd