1111111
1100001
1103101
1000101
1400001
1010211
1111111

luluuurdduurrdddlll