1111111
1010001
1010041
1030011
1001001
1002001
1111111

lluurrlddrruulur