1111111
1100011
1031001
1001411
1000001
1000021
1111111

luuuullddldrrdru