1111111
1001111
1020041
1003001
1410301
1110011
1111111

drrlddrurullluld