1111111
1000441
1000001
1030001
1030201
1001101
1111111

ululldrrllddruuulurrddrdruu