1111111
1400111
1100001
1103301
1200001
1100401
1111111

ruurrdlrdlluurul