1111111
1100001
1110021
1011001
1030301
1040401
1111111

dddluudldllurrdrruuldrdllrruuuulddd