1111111
1001101
1400041
1130101
1003021
1000011
1111111

ldlluuruldddruulurr