1111111
1110111
1110021
1400311
1100001
1100001
1111111

ldlddrrulldlurul