111111111111
111001111101
100001000001
100000011001
101000000001
111011111011
110011011011
100000000011
110121114011
110001300011
110030000001
111111111111
