111111111111
153010000111
100030011111
100011000001
111011011011
111011041001
111011000001
112011011111
111005013101
100000000001
101010100101
111111111111
