1111111111
1101001001
1001020301
1100301001
1000040011
1110000401
1000100001
1001000011
1104300001
1111111111

ldldrdrrururuuldddldddldl