1111111
1111101
1001001
1020011
1003001
1400011
1111111

rdrdll