1111111
1100041
1000301
1000321
1000301
1004041
1111111

lulurldddrurd