1111111111
1000001111
1000000101
1000014001
1000010341
1110001001
1000001301
1001000001
1010000201
1111111111

ruuuluruldddrddllurdruuu