##########
#.@ ######
# $#######
#    $ ###
#     . ##
#       ##
##    ####
##########
##########
##########
