##########
##########
##########
#  #######
# ########
#  #######
#    @$. #
#  $     #
#  .##   #
##########
