##########
##########
##########
##########
##########
#  @  ####
# $$ #####
#    #####
#..   ####
##########
