##########
##########
##########
##########
##########
##   #####
### ######
##@$ .$ .#
##       #
##########
