##########
### $  . #
###.   $@#
#######  #
##########
##########
##########
##########
##########
##########
