##########
###      #
####     #
#### .# ##
####  . ##
######  ##
######  ##
######$$ #
###### @ #
##########
