##########
##########
#####  ###
# ###  ###
# $    # #
#   .  $@#
######.  #
######   #
##########
##########
