##########
###     .#
###  .   #
#####   ##
#####  $##
######$ ##
######@###
##########
##########
##########
