1111111
1001001
1142011
1003011
1030041
1001011
1111111

dllddruudrr