1111111
1110001
1200301
1111041
1000001
1111101
1111111

rrrurd