1111111
1001011
1001011
1020001
1103401
1000101
1111111

dr