1111111
1110011
1001001
1100001
1102301
1140001
1111111

urdrdll