1111111
1000001
1110001
1003101
1000041
1200001
1111111

rrrruuulldldrr