1111111
1000101
1110001
1000001
1103411
1002001
1111111

lur