1111111
1040011
1002001
1003011
1001001
1110011
1111111

rdlullddruu