1111111
1000101
1020001
1010011
1003001
1403411
1111111

rrdddllururd