1111111
1004011
1140001
1000101
1123301
1000001
1111111

druuurrddlldluu