1111111
1100001
1403121
1100001
1003401
1111001
1111111

ulldldrldruuurrddlldlurul