1111111
1110001
1111411
1120011
1003011
1000001
1111111

drdruu