1111111
1040101
1000001
1030121
1001001
1000011
1111111

dldlluuu