1111111
1100001
1100001
1100111
1102001
1143011
1111111

rdl