1111111
1000001
1002011
1103001
1100011
1000401
1111111

ddldr