1111111
1021101
1000001
1001301
1100401
1001001
1111111

drrd