1111111
1000011
1010001
1030011
1021001
1100411
1111111

lurrurdd