1111111
1002001
1103011
1010041
1000111
1000001
1111111

ldrurdldr