1111111
1000401
1010301
1100201
1101001
1110001
1111111

u