1111111
1001011
1101011
1100001
1023011
1434001
1111111

urrddlluurd