1111111
1110041
1000301
1100001
1200001
1001101
1111111

rrruulur