1111111
1100011
1000011
1030041
1201101
1101001
1111111

urrr