1111111
1100001
1100011
1020011
1013401
1000001
1111111

lddrruulururdd