1111111
1111111
1001011
1101001
1100001
1003241
1111111

ulldrr