1111111
1000011
1021311
1114001
1000001
1101001
1111111

urrddrddlurul