1111111
1000001
1101001
1400201
1103101
1100011
1111111

llddruluuurrddll