1111111
1410001
1300011
1000201
1101001
1110011
1111111

lllu