1111111
1001101
1000001
1021011
1011001
1430001
1111111

urrdddll