1111111
1100401
1100101
1000301
1012001
1111111
1111111

rruldluulur