1111111
1100101
1040001
1100301
1000101
1200001
1111111

rrrruulldlu