1111111
1000011
1130011
1040141
1002301
1100001
1111111

rdrulluuuld