1111111
1000011
1110301
1000041
1200001
1001101
1111111

rruuurdldr