1111111
1012041
1000001
1030001
1003101
1040101
1111111

dldlddrruulduurrdru