1111111
1111141
1111021
1003001
1100301
1104001
1111111

lddllurrdruudddl