1111111
1110001
1000001
1130001
1100301
1424001
1111111

ruuulddrdlrrrululd