1111111
1011101
1000001
1003011
1000401
1012011
1111111

ulururd