1111111
1430201
1010101
1100011
1111011
1110001
1111111

ll