1111111
1114041
1100011
1023001
1003001
1010001
1111111

drdruuulurdddluu