1111111
1140101
1120001
1003011
1000001
1100011
1111111

rrdldluu