1111111
1000001
1011301
1002001
1000401
1101111
1111111

rruuldd