1111111
1110021
1101001
1100311
1001001
1010411
1111111

lddd