#######
#. # ##
#     #
# $  ##
#    @#
# #   #
#######
