111111111
111111111
110001111
110000211
110010011
114300011
110101111
111111111
111111111

lddll