111111111
111111111
110100011
110000111
110030011
110210011
110040011
111111111
111111111

ururddrdl