111111111
111111111
110000111
111000011
111410011
110203011
111000011
111111111
111111111

rdrrulldlu