111111111
111111111
111210011
110010111
111000011
110304011
110001011
111111111
111111111

ddrddllurr