111111111
111111111
111000011
111003011
110000011
110001011
110041211
111111111
111111111

uuululddd