111111111
111111111
110101011
110040011
110002011
111013011
110000011
111111111
111111111

rddluurul