111111111
111111111
110111011
110400011
110012011
110003111
111100011
111111111
111111111

ullddrdruurull