111111111
111111111
114100111
110000011
113030011
110201411
111100011
111111111
111111111

luurdrrurd