111111111
111111111
110040011
110312011
111000011
110000111
111000011
111111111
111111111

dllulur