111111111
111111111
111001111
111421111
110003011
111000011
110000111
111111111
111111111

ddrrulldlu