111111111
111111111
110100011
110001111
111300011
111401111
111020011
111111111
111111111

uuuld