111111111
111111111
110110111
110000111
110410111
110030111
112000011
111111111
111111111

rrruldlu