111111111
111111111
111002011
111003411
110003411
110010011
110100111
111111111
111111111

ldrldr