111111111
111111111
110042011
110031011
110100011
110001011
110011111
111111111
111111111

rddllu