111111111
111111111
114000111
110000111
110000011
111030111
110020111
111111111
111111111

uuurull