111111111
111111111
112400011
110310011
110000011
110011111
111000111
111111111
111111111

ddru