111111111
111111111
110200011
110110111
110000011
110300111
110004011
111111111
111111111

lddrdldrr