111111111
111111111
110011111
111040011
110020111
110103011
110100011
111111111
111111111

ddrruldluu