111111111
111111111
110100011
110300011
110001111
110040011
110021111
111111111
111111111

lluuurrurrdluldd