111111111
111111111
110021111
110000111
110000011
110301011
114000111
111111111
111111111

ldddrdl