111111111
111111111
111111211
111110011
111003111
110110011
114000011
111111111
111111111

dlddrdlll