1111111111
1100000001
1004000011
1000000001
1100100301
1130012001
1000010101
1010400101
1001011101
1111111111

rurulllluldddrddluluurdluulurddddrurd