111111111
111111111
111001111
111000011
110030011
111004211
110000011
111111111
111111111

lllururd