111111111
111111111
111101111
110020011
110000311
110000011
111100411
111111111
111111111

rrdd