111111111
111111111
111400111
111000111
111300111
110000011
110021011
111111111
111111111

luuu