111111111
111111111
110020011
110000011
110300011
110000111
110004011
111111111
111111111

ldddldrr