111111111
111111111
112100111
110000011
111001011
110030011
111004011
111111111
111111111

drrddldr