111111111
111111111
110010011
111000011
111200011
114003011
110100011
111111111
111111111

rrrdlll