111111111
111111111
110000111
110100411
111023011
111010011
111011111
111111111
111111111

rdru