111111111
111111111
110111111
110101011
110004211
110300111
111001111
111111111
111111111

llddlulurr