111111111
111111111
111000111
110123111
110040011
111100011
110000111
111111111
111111111

urdlddrrul