111111111
111111111
111110011
110000011
110310011
114000011
110021011
111111111
111111111

lluuurdlddrrul