111111111
111111111
110010111
110400111
110200111
110003011
111100011
111111111
111111111

rddrruldluurul