111111111
111111111
112000111
110000111
110130011
110100411
110100111
111111111
111111111

rrrdddluruulldrurddldr