1111111
1110001
1003001
1100001
1124101
1100001
1111111

ruruuldd