1111111
1104011
1003001
1000001
1100201
1000011
1111111

luu