1111111
1024011
1000001
1003001
1030011
1011411
1111111

ldddrruurdd