1111111
1000001
1402001
1003011
1000001
1000001
1111111

rdlldlu