1111111
1400001
1400111
1003011
1300001
1200101
1111111

uuurrdrdlldluu