#######
# #   #
# #   #
#   .$#
#   $.#
#   @ #
#######
