#######
### @##
##    #
## . ##
#   $ #
#     #
#######
