1111111
1040111
1102011
1031101
1000001
1000111
1111111

ldlddruuu