1111111
1101111
1000001
1030101
1201101
1400111
1111111

uurrdluldd