1111111
1101001
1102011
1100001
1030101
1000411
1111111

lddldrr