1111111
1110001
1040111
1103011
1120001
1110111
1111111

rruldlu