1111111
1000001
1011001
1000011
1101321
1110401
1111111

dluullluurrrddd