1111111
1000001
1110101
1140111
1102301
1100001
1111111

drrulldlu