1111111
1010111
1000041
1200101
1003101
1100111
1111111

rddruulurr