1111111
1040001
1100301
1000101
1100101
1201001
1111111

ruruuurrdlldlu