1111111
1043011
1000021
1001111
1100111
1110001
1111111

lul