1111111
1000001
1104001
1120301
1100001
1100011
1111111

rdrurul