1111111
1140001
1102011
1003011
1000001
1100011
1111111

rdldluu