1111111
1000001
1120001
1004101
1100301
1110001
1111111

rrrddldlu