1111111
1004011
1030001
1110001
1012011
1000341
1111111

uuulldrurrddludddr