1111111
1010401
1000001
1203011
1000011
1000001
1111111

rrdruu