1111111
1114001
1000001
1100101
1203011
1000001
1111111

rdruuu