1111111
1001011
1100011
1001311
1024001
1000001
1111111

uurrdullddrdrrul