1111111
1100111
1014001
1010111
1030021
1000011
1111111

lldllurdruu