1111111
1110001
1002011
1001001
1034011
1011011
1111111

llddr