1111111
1101101
1200101
1040001
1000301
1000001
1111111

rrdrrdlldlu