1111111
1420011
1000001
1100311
1003041
1100111
1111111

rrddllddrurluurull