1111111
1010001
1000101
1112001
1003401
1100011
1111111

rddllur