1111111
1011101
1200001
1030101
1100041
1000111
1111111

drurdldrr