1111111
1111011
1100001
1140101
1130001
1200101
1111111

ru