1111111
1110101
1034201
1000101
1011001
1000101
1111111

ldllur