1111111
1000111
1030001
1010001
1000401
1001021
1111111

lullluururddullddrr