1111111
1110001
1100011
1102401
1013001
1000001
1111111

rddluruulldr