1111111
1000001
1003111
1100001
1400301
1142101
1111111

uurrdllluuurddrdluld