1111111
1011001
1040011
1001001
1030111
1002001
1111111

luu