1111111
1110001
1010001
1002111
1003401
1110011
1111111

ldr