1111111
1000011
1003111
1000001
1100001
1200041
1111111

ruuuurdddldrr