1111111
1011011
1020011
1041011
1003011
1001001
1111111

rrddlruullldddru