1111111
1010001
1040001
1002301
1101011
1000001
1111111

lddrruurull