1111111
1100401
1130001
1430201
1000101
1010111
1111111

ldllurdruruulldrdlrru