1111111
1000001
1140001
1023101
1000001
1000111
1111111

druluurrdl