1111111
1400011
1003001
1100001
1100001
1020111
1111111

ruuurull