1111111
1000111
1000201
1034001
1000011
1110001
1111111

llldr