1111111
1000011
1003011
1211411
1000011
1110001
1111111

urrurd