1111111
1011001
1003421
1100011
1001001
1000011
1111111

ldllur