1111111
1120111
1130001
1001111
1100001
1400101
1111111

dddrdl