1111111
1010011
1000201
1000001
1030101
1100411
1111111

lllddrurdldr