1111111
1110001
1000011
1010041
1032001
1000011
1111111

dllurrdrulur