1111111
1110021
1000001
1403001
1130411
1100111
1111111

lldldrurdlddlurul