1111111
1100001
1230001
1001041
1100111
1000001
1111111

rrrurd