1111111
1020001
1000111
1043011
1100001
1001001
1111111

dddrrul