1111111
1000101
1140001
1000201
1003101
1100011
1111111

llddruurul