1111111
1000011
1030001
1100001
1040201
1101111
1111111

luuuldd