1111111
1011111
1004001
1000011
1203011
1000111
1111111

rdruu