1111111
1010001
1000111
1013001
1240001
1001001
1111111

uurrdrdl