1111111
1110001
1100121
1001011
1003001
1400011
1111111

ulldldddrrulluld