1111111
1100011
1030011
1000201
1100001
1000401
1111111

lllurrurddd