1111111
1020001
1003101
1040001
1000011
1001001
1111111

rdlddrrul