1111111
1040001
1000001
1010011
1113011
1002011
1111111

uuurul