1111111
1000111
1030101
1010101
1010001
1020411
1111111

luuururddduulldddrr