1111111
1011201
1001001
1000001
1030141
1043001
1111111

ddllldrurrrddllulurrurd