1111111
1100401
1100001
1000201
1003101
1000001
1111111

llddruuulur