##########
# ##@#####
#  $$.  ##
#.    ####
# ########
#  #######
# $ ######
#   ######
#  .######
##########
