##########
##########
##########
#######  #
######.. #
######   #
###### $ #
######$$ #
######.@ #
##########
