##########
#######  #
#######  #
######. .#
######.  #
######   #
###### $ #
######$$ #
######@  #
##########
