##########
#@#### ###
#$       #
# .# #  ##
#  #######
#$$#######
#  #######
#.########
#.########
##########
