##########
# ########
# ########
# ########
# ########
#.########
#$ #######
#  # #####
#.$@$. ###
##########
