##########
###   ####
###$$ ####
###   ####
##  . ####
#  $ #####
# .@. ####
#    #####
##########
##########
