##########
##########
##########
##########
# ########
#.$  #####
#@$ . ####
# $  .####
#  #######
##########
