##########
##########
##########
#######. #
######   #
#######  #
#######  #
## ####$ #
##     @ #
##########
