##########
##########
######@###
######$###
######  ##
##### .###
#####    #
######   #
######   #
##########
