##########
#   . ####
#     ####
# $    ###
# @    ###
##########
##########
##########
##########
##########
