##########
######   #
######   #
######   #
###### . #
#######  #
######   #
#####@$  #
#####   ##
##########
