##########
##########
#######  #
#####  . #
#@$      #
## #     #
####     #
####     #
######   #
##########
