##########
###@######
#  $    ##
##     ###
#####   ##
######   #
#####    #
#####   .#
######   #
##########
