##########
##########
##########
##########
####  ## #
#####    #
###   .  #
####@$   #
#######  #
##########
