##########
#        #
#  .  #  #
#      $ #
#      @ #
# ########
# ########
##########
##########
##########
