##########
##   @ ###
##  #$####
##  # ####
##.    ###
#      ###
#     ####
##########
##########
##########
