##########
##########
##########
######  ##
####@$   #
####     #
###   . ##
### #   ##
### #  ###
##########
