##########
##########
##########
##########
##########
##### ## #
#####.#  #
####   $@#
####     #
##########
