1111111
1010001
1400101
1020101
1000331
1100041
1111111

ruurrdddlldluurul