1111111
1140001
1200001
1130101
1100301
1400111
1111111

rddruurrddlldluuu