1111111
1000111
1003101
1040001
1003011
1410201
1111111

ulluuurdllddrrrul