1111111
1000001
1101001
1102411
1103101
1000001
1111111

lddrulur