1111111
1004011
1003001
1013011
1100021
1104101
1111111

luulduulldrurrddludd