1111111
1010041
1030001
1003011
1010401
1112011
1111111

ruuuldllurrdrudddluulururdd