1111111
1101001
1100011
1104001
1003211
1100001
1111111

dlu