1111111
1120111
1000001
1000001
1403111
1100011
1111111

ddddruluurrdlluld