1111111
1110401
1000001
1010311
1000211
1110001
1111111

uu