1111111
1001021
1101001
1003001
1100401
1101101
1111111

ldddllurdrruuld