1111111
1001111
1003001
1002411
1100111
1000001
1111111

ruldlluurdldrr