1111111
1100001
1100101
1043001
1201001
1101011
1111111

ruruurrddll