1111111
1041101
1102001
1103001
1100001
1100001
1111111

rdldluu