1111111
1110011
1200001
1100101
1030041
1000001
1111111

rrdddllurrr