1111111
1101001
1140201
1001111
1030011
1001001
1111111

lldlddruu