1111111
1101141
1000001
1100201
1000311
1110001
1111111

lddruulurdru