1111111
1000011
1021001
1103411
1000001
1101011
1111111

dr