1111111
1001001
1034001
1020411
1010301
1110011
1111111

lurdrddru