1111111
1010001
1021001
1000001
1030011
1410001
1111111

drdluld