1111111
1140021
1001301
1100001
1110101
1110101
1111111

ddlurull