1111111
1100011
1123011
1000001
1030011
1041411
1111111

rurdddluld