1111111
1001011
1000301
1000401
1001121
1000001
1111111

uulldlluurdldrr