1111111
1000111
1430001
1101021
1100111
1110001
1111111

lull