1111111
1211011
1000001
1000401
1131011
1000001
1111111

drrrdddlludrruululldrr