1111111
1120001
1110101
1113101
1110101
1104001
1111111

rddd