1111111
1101021
1001001
1400301
1010101
1001101
1111111

ddlll