1111111
1004001
1000001
1203011
1000111
1110111
1111111

rdruu