1111111
1112001
1100401
1101011
1103011
1100001
1111111

dlddrdruu