1111111
1100001
1102001
1110301
1040001
1010001
1111111

rdrdll