1111111
1100001
1200041
1011001
1010031
1010001
1111111

rrrdddruu