1111111
1000211
1400111
1030111
1000111
1001111
1111111

lddldlu