1111111
1100011
1204301
1000001
1111011
1100011
1111111

rrdrrul