1111111
1011001
1010001
1013021
1000011
1040001
1111111

lulddrdl