1111111
1111001
1100411
1000021
1013011
1110001
1111111

lddluulur