1111111
1004011
1000011
1100011
1002301
1010001
1111111

drruldluuu