1111111
1100011
1001111
1431001
1002001
1000101
1111111

lluurdlddrruldlu