1111111
1110011
1400101
1030001
1101021
1100011
1111111

ldlluurul