1111111
1000201
1100001
1030111
1004001
1000011
1111111

llddldr