1111111
1011011
1000001
1400001
1023011
1100011
1111111

drurull