1111111
1110011
1000001
1430101
1002101
1100001
1111111

ul