1111111
1000041
1000001
1100311
1100001
1200011
1111111

rrruuulur