1111111
1102001
1030001
1000011
1000011
1014011
1111111

ldldrurdd