1111111
1041011
1400001
1102301
1000301
1101001
1111111

urrdllrrddluurulllrddluu