1111111
1400001
1104311
1100011
1002301
1010001
1111111

drruldluruldluurulrrddlddrruldluu