1111111
1000211
1000011
1103001
1400101
1000101
1111111

ddluldrdl