1111111
1001001
1141011
1001001
1103021
1000001
1111111

lldluu