1111111
1010011
1003041
1000001
1002101
1000101
1111111

luurr