1111111
1110111
1000001
1200131
1030401
1101141
1111111

drruurrdd