1111111
1000001
1000011
1423001
1010101
1001101
1111111

urrdll