1111111
1004011
1000001
1203001
1100011
1100001
1111111

rdruu