1111111
1100121
1400001
1013101
1110001
1000101
1111111

dddlludrruulll