1111111
1100001
1110001
1004311
1002001
1100011
1111111

ruluurrdluld