#######
#  $ .#
#   # #
#   # #
#  @  #
### # #
#######
