#######
#@   ##
#     #
#    .#
#  $  #
#     #
#######
