1111111
1010011
1001001
1000001
1011301
1402001
1111111

rruuldrdlll