1111111
1102001
1003301
1001041
1400011
1100011
1111111

rdlulddldrdrruudlluurrurd