1111111
1100001
1040021
1101301
1000001
1100101
1111111

ddlurull