1111111
1000001
1103011
1004001
1000021
1030041
1111111

lllldrrruuuuld