1111111
1101001
1040001
1203341
1100001
1000001
1111111

rdrurul