1111111
1000041
1311211
1003001
1410011
1010111
1111111

ulllddrrdruudllluurrr