1111111
1043001
1013011
1012001
1014001
1001101
1111111

ruuldd