1111111
1140011
1100001
1001001
1123001
1000011
1111111

drruldluuu