1111111
1000201
1003011
1110001
1001011
1100401
1111111

lldrurddd