1111111
1100401
1100301
1001001
1100001
1201011
1111111

rurruu