1111111
1104001
1103001
1101001
1000201
1101111
1111111

lluurlddrruurul