1111111
1011001
1011001
1030001
1000011
1120401
1111111

ulurrdruruulddd