1111111
1112011
1100011
1030101
1403001
1140001
1111111

dldrdlrrdl