1111111
1000001
1030011
1130001
1000201
1404011
1111111

luuulldrddrdluuuurddd