1111111
1100011
1001311
1000241
1100101
1100101
1111111

lluurrdullddrr