1111111
1101011
1000041
1011301
1403001
1120001
1111111

rruuddlluluurrrddll