1111111
1000011
1100001
1001101
1143001
1001021
1111111

lul