1111111
1400001
1103011
1001211
1030411
1001001
1111111

uullddlddruuurulrrdd