1111111
1000001
1030011
1400021
1000001
1000001
1111111

llululd