1111111
1001001
1001421
1031001
1000001
1000011
1111111

lddllluurdldrrdruu