1111111
1000011
1101041
1000001
1020031
1100001
1111111

rrdruu