1111111
1111111
1000011
1003401
1000021
1101001
1111111

lllur