1111111
1000001
1203101
1004101
1000011
1111111
1111111

rurd