1111111
1011111
1001011
1003211
1000401
1000011
1111111

ldlluurdldrr