1111111
1000001
1100301
1000401
1002101
1000001
1111111

uuurd