#######
## #  #
##    #
#   $ #
## #. #
#### @#
#######
