#######
##.# ##
##$   #
#    .#
#  $  #
#@.$  #
#######
