#######
# @   #
# . ###
# $$ ##
#    ##
#.  ###
#######
