#######
## #  #
# $   #
#@#   #
# .   #
#     #
#######
