1111111
1000011
1003001
1040001
1101011
1002011
1111111

ruuululd