1111111
1100001
1000111
1103041
1002001
1101001
1111111

lurr