1111111
1000211
1000001
1001011
1030401
1010101
1111111

llldddrr