1111111
1011201
1000011
1000301
1000001
1000041
1111111

dddldr