1111111
1110001
1032041
1000101
1000001
1000101
1111111

dllurrr