1111111
1010011
1032001
1003001
1040101
1000041
1111111

rdldlluurrurdlldrrurdd