1111111
1001021
1100011
1003001
1100001
1100401
1111111

ldlddldr