1111111
1100001
1000001
1032401
1000101
1110101
1111111

ulldrr