1111111
1001041
1001101
1012101
1010031
1000001
1111111

drdruuu