1111111
1001101
1000001
1124001
1003101
1000111
1111111

ddru