1111111
1000111
1430111
1430001
1000001
1102001
1111111

uulrul