1111111
1001011
1043001
1000011
1023001
1004001
1111111

urruldd