111111111111
100101100111
100000000021
100131010001
104000010111
101000010001
100000113011
101100110011
101110344001
100000000001
111000000011
111111111111
