1111111
1430101
1100001
1100001
1000201
1010011
1111111

luuul