1111111
1001001
1003001
1000001
1004001
1102001
1111111

luuurdrruulddrdl