1111111
1400001
1032011
1101011
1100011
1111001
1111111

rddlluurul