1111111
1021011
1100011
1100001
1101101
1104301
1111111

drrdrddl