1111111
1000041
1233001
1400011
1000001
1100101
1111111

urdrdlrrulur