1111111
1000001
1033001
1000011
1024101
1400001
1111111

luuurrddululddd