1111111
1400111
1000011
1003011
1002001
1100101
1111111

rulldluu