1111111
1400001
1000001
1033041
1100021
1000011
1111111

lllurrllurul