1111111
1001101
1000001
1032011
1403401
1000001
1111111

luldrdr