1111111
1041111
1000201
1003041
1003011
1001001
1111111

lldrrdlullddruuu