1111111
1401101
1011101
1301001
1002001
1010101
1111111

lluu