##########
# ########
#  #######
#  #######
# ## .# ##
#@$      #
##       #
##########
##########
##########
