##########
##########
##########
######## #
######## #
#######@ #
#######$ #
#######  #
###### . #
##########
