##########
#  #######
# ########
#  #######
# ########
#     .###
#      ###
# $  #####
# @  #####
##########
