##########
##########
##########
# @#######
# $#######
# .#######
#  #######
#   # ####
#       ##
##########
