##########
##########
#######  #
######  ##
######.  #
######   #
######   #
###### $ #
###### @ #
##########
