##########
##########
#######@ #
#######$ #
#######  #
######   #
######   #
######   #
##  .    #
##########
