##########
##       #
##     $@#
##  ##   #
## . #####
##########
##########
##########
##########
##########
