##########
#### @   #
#### $ # #
####     #
#####    #
#####   .#
##      ##
###     ##
##########
##########
