##########
##########
##########
##########
### ######
#.      ##
#     $@##
#    ## ##
## # #####
##########
