#######
# #.@ #
# $   #
#    ##
#    ##
#     #
#######
