#######
#     #
#  #  #
#  $ ##
#  @  #
#.  # #
#######
