#######
#     #
#  .  #
#  $ @#
#     #
# #  ##
#######
