1111111
1011011
1011001
1010001
1020301
1010041
1111111

rrurd