#######
#  @  #
##    #
#     #
#$    #
#.# ###
#######
