#######
###@ .#
#     #
#     #
#  $  #
#     #
#######
