#######
#@  # #
#.  # #
#$    #
#  ## #
#   # #
#######
