#######
##    #
#. @  #
##$$. #
#     #
#     #
#######
