#######
#    ##
#     #
#  $. #
# .@$ #
##   ##
#######
