#######
## # ##
#    ##
#.    #
## $  #
#  @# #
#######
