#######
#  ## #
#..   #
# @$  #
#$ # ##
# .$  #
#######
