#######
# ##  #
#     #
# # @ #
# ##$ #
# ## .#
#######
