#######
# .####
#   @ #
#  $ .#
#  $ ##
#  #  #
#######
