#######
#   ###
#    ##
#  @ ##
#.$   #
#    ##
#######
