111111111
111111111
111110011
110000011
112010011
113100011
114000011
111111111
111111111

d