111111111
111111111
111001111
110410111
111000011
110031011
112000011
111111111
111111111

rrudrruulldlu