111111111
111111111
110000011
110011011
110000011
111201111
114300011
111111111
111111111

rdl