111111111
111111111
111000011
111000011
112003011
110140011
111100011
111111111
111111111

rrurdrdl