111111111
111111111
111011411
111000011
111010011
110030011
111002111
111111111
111111111

llurdruudlluurrdru