111111111
111111111
111011111
111010011
110010011
110430211
111000111
111111111
111111111

ll