111111111
111111111
111001411
111011011
111000011
111030011
111020111
111111111
111111111

ulurrdruu