111111111
111111111
111011111
112001011
111101411
110000311
111010011
111111111
111111111

rrddrdru