111111111
111111111
111101211
110000011
113110111
114000011
110010111
111111111
111111111

dlllld