111111111
111111111
110001111
110311011
110010011
112400011
110000011
111111111
111111111

uuurdd