1111111111
1000000401
1010300111
1000100001
1100101001
1000000101
1000001101
1000020001
1100001001
1111111111

lluuuuurrdrulur