1111111
1410001
1000101
1000001
1003111
1112001
1111111

uluruurrddllldluu