1111111
1141001
1200011
1100001
1000301
1100001
1111111

rrrdrdlldluuu