1111111
1001011
1402001
1113001
1000001
1000111
1111111

rddlurull