1111111
1101111
1101011
1001201
1001301
1004001
1111111

drdl