1111111
1101041
1000301
1010101
1203041
1000011
1111111

rdrruluurlddrruullllddrrr