1111111
1101111
1430001
1002001
1010011
1110001
1111111

ul