1111111
1011111
1000001
1300011
1401001
1120001
1111111

uuuld