1111111
1040001
1000001
1002301
1100111
1000001
1111111

urrdlldluu