1111111
1110011
1001001
1003001
1101141
1000021
1111111

llluurrurd