1111111
1000011
1100041
1030001
1010201
1000111
1111111

ldlluurrrdru