1111111
1010001
1040001
1002001
1003001
1100011
1111111

rdldluu