1111111
1000011
1013001
1004111
1002001
1000011
1111111

lluuurrd