1111111
1001011
1140011
1110001
1023001
1000001
1111111

druurul