1111111
1000011
1111001
1043001
1200001
1001101
1111111

rrrul