1111111
1100001
1110101
1102301
1040001
1011011
1111111

drrulruullddrdl