1111111
1002011
1100311
1000001
1101411
1001001
1111111

rdd