1111111
1100101
1110001
1120101
1143001
1111111
1111111

rurrddll