1111111
1011011
1020011
1000011
1043101
1100001
1111111

dddruluurrdluld