1111111
1110211
1000011
1000011
1143001
1001101
1111111

dddl