1111111
1000001
1001301
1000041
1101001
1102101
1111111

luuuurrdullddrr