1111111
1040011
1100111
1103001
1002001
1010001
1111111

ruldluu