1111111
1430101
1000101
1100001
1100201
1000011
1111111

luuul