1111111
1000111
1100001
1101111
1100211
1430001
1111111

ldl