1111111
1140301
1010001
1000111
1100201
1000101
1111111

luurrull