1111111
1000101
1000201
1130001
1000401
1100011
1111111

lddluruulldrurddldr