1111111
1100001
1010101
1000001
1043021
1110001
1111111

ll