1111111
1111021
1400101
1000001
1103001
1110001
1111111

ddlddluruldlurul