1111111
1000041
1110301
1030011
1002041
1011111
1111111

llurdrruulurlddldrr