1111111
1110111
1110011
1020301
1000001
1104001
1111111

rurddrdl