1111111
1110001
1000201
1100401
1003101
1110001
1111111

rdddllulur