1111111
1001011
1301011
1000011
1201001
1411011
1111111

ruuulddd