1111111
1100211
1100401
1101001
1000311
1010001
1111111

lldddrdruu