1111111
1011111
1000341
1010211
1001011
1100001
1111111

lur