1111111
1030041
1003001
1100001
1102111
1400001
1111111

luulurrrdluldddrdl