1111111
1040001
1003011
1001001
1011211
1001011
1111111

uulullddru