1111111
1011111
1000001
1041111
1130001
1020001
1111111

u