1111111
1000001
1000001
1101041
1023001
1100101
1111111

uurrddldluudrruululldrrrurd