1111111
1000111
1130011
1420001
1000101
1010001
1111111

ruuldrdl