1111111
1000111
1001001
1001001
1003201
1100401
1111111

dllurdrruuld