1111111
1140011
1100211
1041001
1030301
1100001
1111111

drdldlluuurrddldlu