1111111
1400011
1112001
1013101
1000001
1110001
1111111

rrddlluurull