1111111
1100101
1000101
1110001
1030011
1400201
1111111

lllurdrruuldrdll