1111111
1101101
1000101
1010001
1432001
1000011
1111111

l