1111111
1101101
1020001
1010301
1010141
1000011
1111111

rdrurd