1111111
1001001
1011101
1002001
1110131
1100041
1111111

rrd