##########
#. #######
#$ #######
#@# ######
#$     ###
#.#.$ ####
##########
##########
##########
##########
