##########
##########
# ########
# .#######
# $.# #.##
# $@$    #
#        #
##########
##########
##########
