##########
#####@ ###
#####$ ###
#  ## ####
#.##  ####
# . $  ###
#  $   ###
# .### ###
#  #######
##########
