##########
##########
##########
##########
##########
##########
# ##  .###
# $ $ .###
#@$  . ###
##########
