##########
##########
##########
##########
##########
##@#######
##$## ####
#  $.  ###
#.  $. ###
##########
