##########
##########
##########
##### ####
#@ ## .  #
#.$     .#
# $$ #   #
#  ####  #
#######  #
##########
