##########
######   #
###### $ #
#######  #
#######. #
###### $ #
###### $@#
######.. #
######   #
##########
