##########
##########
##########
#@########
#$$.     #
#.#.   $ #
######## #
##########
##########
##########
