##########
##########
##########
##### ####
# #  .####
# .  .  ##
# $   $ ##
##     $@#
#####  ###
##########
