##########
## @  ####
## $ #####
### ######
###  #####
### ######
##  .#####
## .$#####
#  $ . ###
##########
