#######
# $  .#
# #   #
#   # #
#  .$ #
# # #@#
#######
