#######
#     #
# # # #
#   $ #
# @ . #
# ##  #
#######
