#######
##   .#
# @ #$#
#.    #
##$$ ##
## .  #
#######
