#######
#@    #
# # $ #
#    .#
# $.$.#
##    #
#######
