#######
#  . ##
#  #  #
# $ $ #
#     #
###@ .#
#######
