#######
##    #
#  $  #
# # $ #
#.@  .#
##### #
#######
