#######
#   @ #
#. $  #
# $   #
##   .#
## #  #
#######
