#######
# .   #
# .   #
# $ $ #
#   # #
###  @#
#######
