#######
##    #
#.$#  #
#  $  #
# # .@#
#     #
#######
