#######
#  ##.#
#     #
# $ # #
#     #
#####@#
#######
