#######
#.#  ##
#  @  #
#.$ $ #
##    #
#  ####
#######
