#######
# @ ..#
# $ # #
# $   #
#     #
#  # ##
#######
