#######
#    .#
# @$ ##
###   #
#   $ #
#.    #
#######
