#######
#    ##
#.   ##
# $$# #
# @   #
# .####
#######
