#######
#  .  #
#@##  #
###  ##
### $##
###   #
#######
