#######
##   .#
##$ # #
# $   #
#@   ##
# . ###
#######
