#######
## ####
##    #
#  $# #
#     #
#.#  @#
#######
