#######
## ## #
##  @ #
#. $ ##
#   $ #
#.#   #
#######
