1111111
1141011
1130001
1000041
1003001
1243001
1111111

ruuuddrrdlrru