1111111
1020001
1040111
1033011
1000011
1400111
1111111

rddrdlluld