1111111
1110001
1200001
1103001
1043001
1114101
1111111

rrrdluldrd