1111111
1001111
1003011
1040001
1423011
1000011
1111111

drurulrulluldd