1111111
1001001
1030001
1000001
1104201
1100001
1111111

lluluurdldrurd