1111111
1100011
1020111
1130001
1000041
1000111
1111111

drddllurrr