1111111
1004111
1000001
1013101
1002111
1000011
1111111

uu