1111111
1000111
1040001
1131001
1200011
1101001
1111111

ru