1111111
1120041
1111001
1000031
1110001
1000011
1111111

rrdddruu