1111111
1100011
1131001
1140011
1000001
1121101
1111111

urruuulld