1111111
1110201
1400001
1113011
1000011
1001001
1111111

dddlurull