1111111
1010011
1400311
1000001
1001201
1100001
1111111

uluurddrddlurullldlu