1111111
1001021
1001001
1401011
1030001
1001101
1111111

ldddlldlu