1111111
1110011
1112011
1030011
1001001
1100401
1111111

rdddllulurrurdd