1111111
1010111
1000101
1103201
1040011
1110111
1111111

luld