1111111
1402001
1010111
1030011
1000101
1110001
1111111

ddldluu