1111111
1100111
1100001
1400301
1100001
1100201
1111111

ruulll