1111111
1111011
1000011
1030111
1400001
1000201
1111111

luululd