1111111
1100111
1110001
1142001
1131011
1100001
1111111

rddllu