1111111
1000001
1103011
1000001
1120001
1100411
1111111

uururddd