1111111
1100001
1141301
1200001
1001101
1001101
1111111

ruurrdrdllruullddlddruu