1111111
1201011
1010011
1300111
1000101
1400001
1111111

ddd