1111111
1200001
1101011
1100041
1001301
1101001
1111111

rrrddrddluruluullddrr