1111111
1110001
1000001
1131001
1400001
1000021
1111111

luuulldurrddll