111111111
111111111
110201111
110011111
111000011
111103411
111101111
111111111
111111111

ddrdr