111111111
111111111
111000111
110200011
110000011
110030011
111040011
111111111
111111111

rdd