111111111
111111111
111000211
111001011
110301111
110400011
110110111
111111111
111111111

llldd