111111111
111111111
114100011
110003011
110110011
110020011
110100111
111111111
111111111

rruulllrrddllluu