111111111
111111111
111100411
110003011
110230111
110010011
111004111
111111111
111111111

ddrruuulldruurddd