111111111
111111111
112110111
110100111
110304111
111010111
111100011
111111111
111111111

ddrr