111111111
111111111
110040011
112031111
110000111
110000011
111001111
111111111
111111111

rdru