111111111
111111111
112140111
110000011
110030011
113110011
114001111
111111111
111111111

dddurrurrddluruldlu