111111111
111111111
110003411
110010011
111030011
112410111
110000011
111111111
111111111

ruuurrddlruulldd