111111111
111111111
111100011
110003011
111001011
110042011
111101011
111111111
111111111

ruululdd