111111111
111111111
111110111
110000011
111023011
110040011
110000011
111111111
111111111

urdrdl