111111111
111111111
110001111
111012011
110001011
111031011
110040011
111111111
111111111

rdddllluurd