111111111
111111111
111004011
110030011
110000111
110032011
110410011
111111111
111111111

luldruulur