111111111
111111111
110001111
111000011
110000011
110131111
110020411
111111111
111111111

lluurrdullddrrr