111111111
111111111
110010011
111400111
111030111
110000011
110000211
111111111
111111111

lluurul