111111111
111111111
111011011
110040011
111110011
111013011
111020111
111111111
111111111

ruurul