111111111
111111111
110021111
111011111
110400011
110300111
110100011
111111111
111111111

lddldrurrddlurul