111111111
111111111
111200011
110000111
110003011
110400011
110110011
111111111
111111111

rrddrdll