111111111
111111111
110100011
110004011
110210011
111300111
110000111
111111111
111111111

urrddldluulurr