111111111
111111111
111001111
111100411
111010011
110230011
110100011
111111111
111111111

rrdruu