1111111
1101111
1100001
1030041
1000101
1102011
1111111

lulurrr