111111111
111111111
110001011
110001011
112311011
114000011
110000011
111111111
111111111

urdlddrrul