111111111
111111111
110000011
110001011
110031011
111000111
110240111
111111111
111111111

uuurdd