111111111
111111111
111000111
110041011
110100011
110030111
111100211
111111111
111111111

lluu