111111111
111111111
110001111
114020011
111301111
110001011
110000011
111111111
111111111

ddlurul