111111111
111111111
111000011
110320111
110400111
111010111
111010111
111111111
111111111

uld