111111111
111111111
111410111
111020011
111030011
111001011
110000011
111111111
111111111

rdldluu