111111111
111111111
110010011
110000111
110003011
111402011
111001111
111111111
111111111

rulluld