111111111
111111111
111004111
110003111
110000111
111010111
112000011
111111111
111111111

rrruuu