111111111
111111111
110001011
111300011
111001111
110001111
110042011
111111111
111111111

luuuuldddldr