111111111
111111111
111000011
111002111
111013011
110040011
110000111
111111111
111111111

drdl