111111111
111111111
110001111
111020111
110430011
110000111
111100111
111111111
111111111

rdl