111111111
111111111
110000111
110000111
110024011
110300011
110000111
111111111
111111111

lldrrdru