111111111
111111111
111100111
111230111
110010011
110010011
110004111
111111111
111111111

rurddd