111111111
111111111
111000011
111013011
114000011
111201011
111101011
111111111
111111111

uuurrdrdlll