111111111
111111111
110001111
111000011
112011011
111003011
110410011
111111111
111111111

rurrrddllrruullldd