111111111
111111111
110021011
110103411
110000111
110101111
110100111
111111111
111111111

dr