111111111
111111111
111000011
111030111
110024011
110300411
110010111
111111111
111111111

lldrrrlluururd