111111111
111111111
110000011
111000011
110031411
111000111
111100211
111111111
111111111

lluulurrurd