111111111
111111111
110001111
110040011
110300211
111001111
110000011
111111111
111111111

lldlulur