111111111
111111111
111110011
111200111
110011111
110000011
114300111
111111111
111111111

ddrdl