111111111
111111111
110110111
110000011
114000011
110310011
110210011
111111111
111111111

uluurrdl