111111111
111111111
110024111
111000011
110031111
110000011
110111011
111111111
111111111

ldddruulur