111111111
111111111
111211011
110410011
110030011
110000011
111110111
111111111
111111111

dddrruldlu