111111111
111111111
110000011
110030011
111410011
110002111
111010011
111111111
111111111

uululd