111111111
111111111
111111111
110002011
110410011
110030111
111000111
111111111
111111111

ddldlu