111111111
111111111
110110011
110000111
110002011
110134011
110000011
111111111
111111111

ddluruulldrurd