111111111
111111111
110000411
110000111
110030011
111200111
110001111
111111111
111111111

ruulurr