111111111
111111111
110011111
111000011
110031011
110002011
111140111
111111111
111111111

lluurdd