111111111
111111111
110020111
110000011
110000411
110030011
110000011
111111111
111111111

ldddrrdru