111111111
111111111
110001211
111011011
111000011
111031111
111004011
111111111
111111111

ddlldldr