111111111
111111111
111020111
111110111
110003111
110100411
110101011
111111111
111111111

rddldr