111111111
111111111
110010011
110030211
110001411
110001111
111000011
111111111
111111111

lldllurrrurd