##########
###  ## ##
##       #
##   $$# #
#      # #
#@#### # #
# . #    #
#     .  #
#  ### # #
##########
