##########
# @     ##
#   # # ##
#    $   #
# ##   ###
#   #   ##
#       .#
#  # #  ##
#     ####
##########
