##########
#    ## ##
##      @#
#   ###  #
# # # .  #
# # $    #
#   #    #
##       #
#   # #  #
##########
