##########
##   #  ##
##     .##
# @ #   ##
# # # #$##
# # # #  #
#   #.   #
# $   ## #
#  #   # #
##########
