##########
###     ##
# # ##   #
#   @$. ##
##    # ##
#   # #  #
# $ .    #
#      $ #
# #.# #  #
##########
