##########
#      # #
#####    #
##   #   #
#@ #     #
###   #  #
####     #
#    $#. #
#        #
##########
