##########
## ###   #
#      @##
####     #
#  $.    #
#   ### ##
#  #     #
#     #  #
#     #  #
##########
