##########
#  # .   #
#   @ ####
##       #
#        #
##   ##  #
##       #
#  ####$ #
#       ##
##########
