##########
##     ###
##       #
#  #.##  #
## $  ####
##     @ #
## ###   #
#        #
#     ## #
##########
