##########
#   # # ##
##       #
####.##$ #
#        #
####   # #
#      # #
#### @   #
##   # # #
##########
