111111111
111111111
114000111
110030111
111010011
111021011
110000011
111111111
111111111

luuurrdlrdrddllluuurul