111111111
111111111
110001111
110300011
111004311
112001411
110001111
111111111
111111111

rruuulldrurdldrurrd