111111111
111111111
110000011
111001011
111011011
111203011
111400011
111111111
111111111

rdrrullrruuulllddd