111111111
111111111
111410011
111010011
111030011
110020011
110000111
111111111
111111111

ruldluu