111111111
111111111
111041011
111000011
111200011
111030011
110000011
111111111
111111111

ddruuu