111111111
111111111
110010011
111000011
111203011
110000011
110410111
111111111
111111111

rurrdlluldd