111111111
111111111
111000011
110030011
111200111
110140011
110000111
111111111
111111111

uurdd