111111111
111111111
110000011
111100011
111001011
110043011
112110011
111111111
111111111

urruurrddl