1111111111
1002010001
1010000341
1004030101
1000000001
1001000011
1100010011
1000000011
1100001011
1111111111

rdrrrldll