1111111111
1000011011
1100000021
1000111001
1010104001
1010300001
1000100001
1100000001
1000101001
1111111111

llllldddrrdru