1111111111
1100000111
1100000001
1110111011
1002001011
1100100001
1003000101
1001400001
1101000011
1111111111

lddrrluurrddrdl