1111111111
1100010011
1100000411
1020100011
1010101311
1010101001
1000140001
1030001101
1001000101
1111111111

lddddrrrdruurruuulldd