1111111111
1141111101
1101000001
1203300101
1000000001
1010110101
1100000001
1000400001
1000001101
1111111111

rdrrruuldrdluldluudrdddldr