1111111111
1000000101
1111100001
1100010001
1201000001
1110001001
1111000001
1000031401
1000000001
1111111111

rurrdddddrulurrluurrdd