1111111111
1401010001
1000000021
1000011111
1000010001
1000010011
1101100011
1003000001
1000000101
1111111111

llllllddddddrruldluuuruldluuu