1111111111
1000001001
1000000001
1200110301
1010110001
1010300001
1010000141
1000040001
1010011111
1111111111

rrddrrrurrululdddduurrdddlluururd