1111111111
1001040001
1000201111
1100000001
1000000001
1100011001
1100000001
1001111301
1000000011
1111111111

llddddddrrrrruuuurulldluu