1111111111
1000001011
1111040011
1100000001
1100021101
1000000001
1010110001
1003100101
1100010001
1111111111

llldlddrdruuulurrdruu