1111111111
1000004011
1000000011
1103100001
1110000001
1000000011
1030010001
1000301411
1401120001
1111111111

rruuullulluulurrrdddrddrddllulululldrruuuuurrdddrdrdddllullluulddruurrruuurddrddddlluludluurrrurdd