1111111111
1000000001
1110101111
1103000201
1000003041
1001011001
1011004101
1000000101
1001000101
1111111111

lluullddldrurddduurrrlllllldddrrrrdru