1111111111
1100000001
1000101001
1000000001
1001001001
1001020001
1100310101
1100004001
1000101101
1111111111

ldldrr