1111111111
1011100101
1000000001
1102101001
1000110001
1113000001
1000410001
1000000011
1000000011
1111111111

ddrddllur