1111111111
1100011011
1001000001
1031000201
1101001001
1000100001
1000000001
1404003001
1101011111
1111111111

llluulldddddrdlrrrurrdlll