1111111111
1100000001
1000011001
1001010011
1104230001
1103011001
1000000011
1000040001
1101000001
1111111111

lddldrrurrruulll