1111111111
1000000001
1101000011
1001000201
1030001301
1004100401
1010000001
1000011011
1111001001
1111111111

dullluulldddldr