1111111111
1000010001
1001104001
1002100001
1000000011
1030000011
1101134101
1000000001
1100000001
1111111111

ldldrrrrdruuudddddllurdru