1111111
1000011
1100001
1104111
1003001
1110021
1111111

llu