1111111
1001001
1200041
1000001
1130001
1403001
1111111

rrrdddlluulurrr