1111111
1000001
1104301
1020001
1000001
1030041
1111111

lddrrruruul