##########
#        #
###  $ @ #
#     ## #
#  ##$   #
# . ### .#
#  #     #
## #   # #
##   # # #
##########
