#######
###  ##
##  ..#
##$  @#
#  $# #
# # ###
#######
