1111111
1141011
1101011
1003011
1100001
1002001
1111111

ruuldluu