1111111
1000201
1300001
1400011
1010001
1110101
1111111

llld