1111111
1000001
1101011
1423011
1000001
1111101
1111111

drrull