1111111
1000001
1010031
1010101
1102041
1001001
1111111

uururdd