1111111
1100001
1030101
1000001
1240001
1111101
1111111

rruuuldd