1111111
1110001
1103011
1000001
1104111
1002001
1111111

uuruuldd