1111111
1000001
1003001
1400101
1013001
1000421
1111111

uuullddullddrruuululd