1111111
1110101
1140001
1123001
1100101
1111101
1111111

drurul