1111111
1010011
1010001
1400311
1000001
1210001
1111111

urruurdlddrruldlurull