1111111
1000001
1000011
1002111
1013011
1004011
1111111

d