1111111
1000011
1011001
1400001
1010301
1210011
1111111

uurrddrurulll