1111111
1000001
1100311
1102411
1000001
1000001
1111111

uurd