1111111
1001011
1100001
1201401
1100311
1000001
1111111

rdrdru