1111111
1000001
1010011
1010101
1013101
1200401
1111111

uuuurrddduuullddddrr