1111111
1100041
1100011
1100111
1003111
1020001
1111111

ruuulurr