1111111
1204011
1000001
1030111
1000001
1000101
1111111

ddrdruu