1111111
1000411
1011001
1103001
1000001
1010021
1111111

llulurdruu