1111111
1011001
1010301
1040001
1001011
1120001
1111111

rruuruuldrdll