1111111
1010011
1200011
1003001
1004001
1010101
1111111

rrd