1111111
1111111
1000001
1130101
1041121
1000101
1111111

uullld