1111111
1101001
1100001
1430111
1000001
1000211
1111111

luul