1111111
1400001
1102301
1110101
1000001
1001101
1111111

urrdlrddlluurull