1111111
1100001
1003011
1004101
1112001
1110101
1111111

uluurd