1111111
1000111
1000011
1100041
1003301
1240101
1111111

rruurrdlluluurdlddurr