1111111
1100101
1000101
1030101
1100401
1100211
1111111

lluulururddldr