1111111
1110111
1000401
1103021
1003011
1000411
1111111

lulldrdldruru