1111111
1410011
1010111
1000111
1000301
1020001
1111111

rrrullldluuu