1111111
1100211
1001001
1110401
1003001
1100011
1111111

ddddllurdru