1111111
1110001
1000401
1130001
1000121
1000011
1111111

ulluldrddllurdruulur