1111111
1102011
1103001
1000111
1100111
1400001
1111111

rdluldddrdl