1111111
1100041
1400001
1110311
1000301
1000201
1111111

ruluddluurullrur