1111111
1110421
1100011
1000001
1030011
1430111
1111111

llddddlulurrdruu