1111111
1000001
1010001
1000011
1030101
1412001
1111111

ululd