1111111
1000101
1012001
1010301
1111001
1000401
1111111

rdd