1111111
1000041
1030201
1101001
1000341
1011101
1111111

lulldrrlddrruulur