1111111
1200011
1010001
1311011
1400011
1111001
1111111

dd