1111111
1100011
1400011
1023011
1100001
1100001
1111111

drurull