1111111
1100101
1110001
1243001
1000011
1100001
1111111

rdrrul