1111111
1400001
1030021
1010101
1100001
1111111
1111111

llulldrurrrdddlluurull