1111111
1040001
1010311
1000001
1000101
1112001
1111111

uuuurdldddrruulrddlluuurul