1111111
1102001
1140001
1100301
1100011
1101011
1111111

rrddlldlu