##########
#   ######
#   ######
#..#######
# $#######
#  #######
#  #######
# $#######
# @#######
##########
