##########
##  ######
#  .######
##  ######
# .   ####
###    # #
###    $@#
###    $ #
###   #  #
##########
