##########
#######  #
##### $. #
###    $ #
# .    @##
#     ####
##########
##########
##########
##########
