##########
##########
##########
##########
##########
###### # #
####  @  #
###. $.$ #
###   #  #
##########
