##########
##########
##########
# ## #####
#   .  $@#
# # $   .#
#    ### #
#  #######
##########
##########
