##########
##########
##########
##########
##########
# ###### #
#  # ### #
#.$    $@#
#    .   #
##########
