##########
# .    $@#
#    .  ##
##      ##
##$ ######
##  ######
##########
##########
##########
##########
