##########
##########
# . ######
##. ######
##    ####
##    ####
## $@ ####
#   $#####
#        #
##########
