111111111111
100010000111
100000300001
100004110101
111010200001
100011131111
101000400001
100000000001
111101011101
100000000101
100001110001
111111111111
