111111111111
100000011101
100001000001
100000000001
100001113001
100010000001
100002110401
100011100101
100000000001
101001001001
100000000001
111111111111
