111111111111
101000000011
100011110041
110000000001
110010100001
100010030101
110210100101
110110140001
100000300011
110000000001
100000001001
111111111111
